apple=elma
car=araba
book=kitap
computer=bilgisayar
dog=kopek
cat=kedi
house=ev
school=okul
teacher=ogretmen
student=ogrenci
pen=kalem
pencil=kurşun kalem
desk=sıra
chair=sandalye
window=pencere
door=kapı
table=masa
lamp=lamba
phone=telefon
key=anahtar
bag=çant
shoes=ayakkabı
shirt=gömlek
pants=pantolon
hat=şapka
glasses=gözlük
watch=saat
water=su
milk=süt
bread=ekmek
butter=tereyağı
cheese=peynir
egg=yumurta
rice=pirinç
meat=et
fish=balık
vegetable=sebze
fruit=meyve
salt=tuz
sugar=şeker
coffee=kahve
tea=çay
juice=meyve suyu
cake=pasta
cookie=kurabiye
ice cream=dondurma
chocolate=çikolata
banana=muz
orange=portakal
grape=üzüm